#########:#########
#______#___#......#
#______#___#......#
#_!!!!_#___#......#
#_!!!!_#___#......#
#_!!!!_#___#......#
#_!!!!_#___#......#
#______#___#......#
#______#___########
#____#_#__________#
#____#_#__________:
#____#____________#
#____###___########
#_____?#___#......#
#______#___#......#
#______#___#......#
#______#___#......#
#______#___#......#
#______#___#......#
#______#___#......#
#########:#########
