#########:#########
#_________________#
#_________________#
#_________________#
#_________________#
#____!___!_!___!__#
#_____!!!___!!!___#
#______!_____!____#
#_________________#
#_________________#
:_________________#
#_________________#
#_________________#
#_________________#
#_________________#
#_________________#
#_________________#
#_________________#
#_________________#
#_________________#
###################
