#########:#########
#____!!___________#
#_____!!__________#
#______!!_________#
#_______!!________#
#________!!_______#
#_________!!______#
#__________!!!!!!!#
#_________________#
#_________________#
:_________________#
#_________________#
#_________________#
#_________________#
#_________________#
#_________________#
#_________________#
#_________________#
#_________________#
#_________________#
###################
