###################
#_________________#
#_________________#
#_________________#
#_________________#
#_________________#
#_________________#
#!_______________!#
#!_______________!#
#!_______________!#
:_________________:
#!_______________!#
#!_______________!#
#!_______________!#
#_________________#
#_________________#
#_________________#
#_________________#
#_________________#
#_________________#
###################
