###################
#_________________#
#_________________#
#_________________#
#_________________#
#_______!_!_______#
#________!________#
#_______!_!_______#
#_________________#
#_________________#
:_________________:
#_____#######_____#
#_________________#
#########_#########
#_________________#
#___!_________!___#
#___!____!____!___#
#_!___!__!__!___!_#
#___!___!_!___!___#
#______!_?_!______#
###################
