###################
#_________________#
#_________________#
#_________________#
#_________________#
#_________________#
#_________________#
#_________________#
#_________________#
#_________________#
#___!_____________:
#____!____________#
#____!!___________#
#____!____________#
#___!_____________#
#___!_____________#
#____!____________#
#____!!___________#
#____!____________#
#___!_____________#
#########:#########
