###################
#_________________#
#_________________#
#_________________#
#_________________#
#_________________#
#_________________#
#_________________#
#_________________#
#_________________#
#_________________:
#_________________#
#!!!!!____________#
#____!!___________#
#_____!!__________#
#______!!_________#
#_______!!________#
#________!!_______#
#_________!!______#
#?_________!!_____#
#########:#########
