###################
#!_______________!#
#########!#########
#____!!_#!#_!!____#
#_#__!!_#_#_!!__#_#
#_#_____________#_#
#_#____#####____#_#
#_#_____________#_#
#_#_____________#_#
#_#_____________#_#
#!#_____________#_:
#_#_____________#_#
#_#_____________#_#
#_#_____________#_#
#_#____#####____#_#
#_#_____________#_#
#_#__!!_#_#_!!__#_#
#____!!_#!#_!!____#
#########!#########
#_________________#
#########:#########
