#########:#########
#_________#.......#
#_________#.......#
#_________#.......#
#_________#.......#
#_________#.......#
#_________#.......#
#_________#.......#
#_________#.......#
#__!!!!___###.....#
:__!__!_____######
#__!!!!___#_#_____#
#_________#_#_____#
#_________#_______#
#_________#_!!!!!_#
#_________#_!!!!!_#
#_________#_!!!!!_#
#_________#_______#
#_________#_______#
#_________#______?#
#########:#########
