#########:#########
#_________#.......#
#_________#.......#
#_________#.......#
#_________#.......#
#_________#.......#
#_________#.......#
#_________#.......#
#_________#.......#
#_________###.....#
:___________######
#_________#_#_____#
#_________#_#_____#
#_________#_______#
#_________#_!!!!!_#
#_________#_!!!!!_#
#_________#_!!!!!_#
#_________#_______#
#_________#_______#
#_________#______?#
#########:#########
