#################
#_______________#
#_______________#
#_______________#
#_______________#
#_______________#
#_______________#
#_______________#
#_______________#
#_______________#
#@______________:
#_______________#
#_______________#
#_______________#
#_______________#
#_______________#
#_______________#
#_______________#
#_______________#
#_______________#
#################
