###################
#_________________#
#_________________#
#_________________#
#_________________#
#_________________#
#_________________#
#_________________#
#________@________:
#_________________#
#_________________#
#_________________#
#_________________#
#_________________#
#_________________#
#_________________#
###################
