###################
#_________________#
#_______________#_#
#_______________#_#
#_______________#!#
#_______________#!#
######__________#!#
#____##_#_______#!#
#__#____#__!!!__#!#
#__##############!#
:__#............#!#
#__################
#__#____#!!!!!!!#_#
#____##_#_______#_#
######__________#_#
#_______________#_#
#_______________#_#
#_______________#_#
#_______________#_#
#_________________#
###################
