###################
#___#_?_?_?_?_?_?_#
#___#!_!_!_!_!_!_!#
#___#_!_!_!_!_!_!_#
#___#!_!_!_!_!_!_!#
#___#_!_!_!_!_!_!_#
#___#_____________#
#___#_____________#
#___#_____________#
#___#_____________#
:___#_____________#
#___#######___#####
#___#_____________#
#___#_____________#
#_________________#
#___#_____________#
#___#_____________#
#___#_____________#
#___#_____________#
#___#_____________#
###################
