###################
#_________________#
#_________________#
#_________________#
#_________________#
#_________________#
#_________________#
#_________________#
:_________________:
#_________________#
#_________________#
#_________________#
#_________________#
#_________________#
#________?________#
#_________________#
###################
