###################
#_________________#
#_________________#
#_________________#
#_________________#
#_________________#
#_________________#
#_________________#
:_________________:
#_________________#
#_________________#
#_________________#
#_________________#
#_________________#
#_________________#
#_________________#
###################
