#########:#########
#_________________#
#_________________#
#_________________#
#___!___!__!___!__#
#____!!!____!!!___#
#_____!______!____#
#_________________#
#_________________#
#_________________#
#_________________:
#_________________#
#_________________#
#_________________#
#_________________#
#_________________#
#_________________#
#_________________#
#_________________#
#_________________#
###################
