#########:#########
#?_________!!_____#
#_________!!______#
#________!!_______#
#_______!!________#
#______!!_________#
#_____!!__________#
#____!!___________#
#!!!!!____________#
#_________________#
#_________________:
#_________________#
#_________________#
#_________________#
#_________________#
#_________________#
#_________________#
#_________________#
#_________________#
#_________________#
###################
