###################
#_________________#
#_____________#####
#_____________#___#
#_____________#___#
#_____________#___#
#_____________#___#
#_____________#___#
#_____________#___#
#_____________#___#
#_____________#___:
#_____________#___#
#_____________#___#
#_____________#___#
#_____________#___#
#_____________#___#
#_____________#___#
#_____________#___#
#_____________#####
#_________________#
###################
