###################
#.............#####
#.............#___#
#.............#___#
#.............#___#
#.............#__!#
#.............#_!!#
#.............#_!!#
#.............#!!!#
#.............#!__#
#.............#!__:
#.............#!__#
#.............#!!!#
#.............#_!!#
#.............#_!!#
#.............#__!#
#.............#___#
#.............#___#
#.............#___#
#.............#####
###################
