###################
#_?_?_?_?_?_?_#___#
#!_!_!_!_!_!_!#___#
#_!_!_!_!_!_!_#___#
#!_!_!_!_!_!_!#___#
#_!_!_!_!_!_!_#___#
#_____________#___#
#_____________#___#
#_____________#___#
#_____________#___#
######___######___:
#_________________#
#_____________#___#
#_____________#___#
#_____________#___#
#_____________#___#
#_____________#___#
#_____________#___#
#_____________#___#
#_____________#___#
###################
