###################
#_________!_______#
#_###############_#
#_#___#_____!___#_#
#_#_#___#__#_####_#
#___#_#####_#___#_#
###_#_##!___###!#?#
#___#_!####_#!#####
#_#_####______#__!#
#!#____!#######_#_#
#!##_####_______#_:
#!#!_#!___#####!###
####_##_###_!_###?#
#_____#_________#_#
#_###_###_###_###_#
#__!#_____#!#__!#_#
#####_#_#_#_##_##_#
#_____#!#___!#_!#_#
#_###############_#
#_!_______________#
###################
