###################
#_________________#
#_______________#_#
#_______________#_#
#_______________#_#
#_______________#_#
######__________#_#
#____##_#_______#_#
#__#____#!!!!!!!#?#
#__################
#__#............#_:
#__##############_#
#__#____#!!!!!!!#_#
#____##_#_______#_#
######__________#_#
#_______________#_#
#_______________#_#
#_______________#_#
#_______________#_#
#_________________#
###################
