#########:#########
#_________________#
#_________________#
#_________________#
#_________________#
#_________________#
#_________________#
#_________________#
#________!________#
#________!________#
#______!!!!!______#
#________!________#
#________!________#
#_________________#
#_________________#
#_________________#
#_________________#
#_________________#
#_________________#
#_________________#
#########:#########
