#########:#########
#_________________#
#_______!!!_______#
#______!_!_!______#
#_______!_!_______#
#________!________#
#_________________#
#_________________#
#_________________#
#_________________#
#_________________#
#_________________#
#_________________#
#_________________#
#_________________#
#_________________#
#_________________#
#_________________#
#________!________#
#______!___!______#
#########:#########
