#########:#########
#____!!!#_#!!!____#
#_________________#
#_________________#
#_###############_#
#_________________#
#_________________#
#_________________#
#_________________#
#_________________#
#_________________#
#_________________#
#_________________#
#_________________#
#_________________#
#_________________#
#_###############_#
#_________________#
#_________________#
#____!!!#_#!!!____#
#########:#########
