#########:#########
#_________________#
#_________________#
#_________________#
#_________________#
#_________________#
#_________________#
#_________________#
#_________________#
#_________________#
#_________________#
#_________________#
#_________________#
#_________________#
#_###_____________#
#___#_____________#
#!#_#_____________#
###_______________#
#!###_#_###_#_____#
#_____#_____#_____#
#########:#########
