#########:#########
#__!__#___________#
#_#####_#####_###_#
#_____#_!#!_#_#___#
#!_##_#####___#_###
##_#!_____###_#!#!#
#__#_###______###_#
#_##!#!########___#
#__#____!#_!#__!###
##!####_?#_##_###!#
#_____####_#____#_#
#####_!______##_#_#
#___##########__#_#
#!#?#!___#!_!#_##_#
#_######_#_#_#__#_#
#___#___!#_#_##_#_#
#!#_#_####_#_#__#_#
###______#________#
#!###_#_###_#_#####
#_____#_____#___!?#
#########:#########
