#########:#########
#__!______________#
#_#####_#####_###_#
#_____#_!#!_#_#___#
#!_########___#_###
##_#!_____###_#!#!#
#__#_###______###_#
#_##!#!########___#
#__#____!#_!#__!###
##_####_?#_##_###?#
#___#_####_#____#_#
#_#_#_!______##_#_#
#_############__#_#
#!#.#!___#!_!#_##_#
#_######_#_#____#_#
#___#___!#_####_#!#
#!#_#_####_#_#__#_#
###______#________#
#!###_#_###_#_#####
#_____#_____#___!_#
#########:#########
