#########:#########
#_________________#
#______!!!!!______#
#_________________#
#___###############
#___#_____________#
#___#_____________#
#___#_____________#
#___#_____________#
#_#!#_#!!!!!!!#####
#_#___#!_!_!_!#?_?#
#_#!###!!!!!!!##_##
#___#_____________#
#___#_____________#
#___#_____________#
#___#_____________#
#___###############
#_________________#
#______!!!!!______#
#_________________#
#########:#########
