#########:#########
#______#___#______#
#______#___#______#
#______#___#______#
#______#___#______#
#______#___#______#
#______#___#______#
#______#___#______#
#______#___#______#
#______#!_!#______#
#______#!!!#______#
#______#!!!#______#
#______#!_!#______#
#______#___#______#
#______#___#______#
#______#___#______#
#______#___#______#
#______#___#______#
#______#___#______#
#______#___#______#
#########:#########
