-----------
-----------
---po------
---v-s-----
---ztj-----
--@cg-n----
----lhp----
-----------
-----------
-----------
-----------
