-----------
-----------
----@------
----v---f--
--s-zhhho--
--khx------
----lhto---
------v----
------n----
-----------
-----------
