-----------
-----------
-----------
-----------
-----------
-----------
-----n-----
--ehtp-----
---plf-----
--@xhp-----
---n-------
