-----------
-----------
----@------
----v------
--s-zhe----
--khx------
----lhf----
-----------
-----------
-----------
-----------
