-----------
-----------
-----------
---@p---f--
--s-zhhho--
--khx------
----lhto---
------v----
------n----
-----------
-----------
