-----------
-----------
-----------
---@i---f--
--s-zhhhj--
--lhxo-----
----lhto---
------v----
------n----
-----------
-----------
