---ethi----
----v-v----
--@hxhg----
----v-v----
--fhchg----
------li---
-------n---
-----------
-----------
-----------
-----------
