-----------
-----------
---po------
---v-s-----
---ztj-----
--@cg-f----
----lhp----
-----------
-----------
-----------
-----------
