-----------
-----------
---po------
---v-s-----
---ztj-----
--@cg------
----lf-----
-----------
-----------
-----------
-----------
