-----------
-----------
-----------
-----------
-----------
-----------
-----------
--eht------
---pl------
--@x-------
---n-------
