---ethi----
----v-v----
--@hxhg----
----v-v----
--fhchg----
------lj---
-------n---
-----------
-----------
-----------
-----------
