-----------
-----------
-----------
---@i---f--
--s-zhhho--
--lhx------
----lhto---
------v----
------n----
-----------
-----------
