---s-------
---v-------
---v-------
---v-------
---v-------
--@xhhhhz--
---v-------
---v-------
---v-------
---s-------
-----------
