#########:#########
#___!!!_____!!!___#
#____!!!___!!!____#
#______!!!!!______#
###################
#.................#
#.................#
#.................#
#.................#
#.................#
#.................#
#.................#
#.................#
#.................#
#.................#
#.................#
#.................#
#.................#
#.................#
#.................#
###################
