#########:#########
#__!!!!_____!!!!__#
#____!!!___!!!____#
#______!!!!!______#
###################
#.................#
#.................#
#.................#
#.................#
#.................#
#.................#
#.................#
#.................#
#.................#
#.................#
#.................#
#.................#
#.................#
#.................#
#.................#
###################
