#########:#########
#_________________#
#_________________#
#_###############_#
#_________________#
#_________________#
#_________________#
#_________________#
#_________________#
#_________________#
#!_!_!_!_!_!_!_!_!#
#_________________#
#_________________#
#_________________#
#_________________#
#_________________#
#_________________#
#_________________#
#_________________#
#_________________#
###################
