#########:#########
#_________________#
#_________________#
########___########
#_________________#
#_____#######_____#
#_________________#
#_________________#
#_________________#
#_________________#
#!_!_!_!_!_!_!_!_!#
#_!_!_!_!_!_!_!_!_#
#_________________#
#_________________#
#_________________#
#_________________#
#_________________#
#_________________#
#_!_!_!_!_!_!_!_!_#
#______?_?_?______#
###################
