#########:#########
#......#___#......#
#......#___#......#
#......#___#......#
#......#___#......#
#......#___#......#
#......#___#......#
#......#___#......#
########___########
#_________________#
:_________________:
#______-__________#
###################
#.................#
#.................#
#.................#
#.................#
#.................#
#.................#
#.................#
###################
