#########:#########
#......#___#......#
#......#___#......#
#......#___#......#
#......#___#......#
#......#___#......#
#......#___#......#
#......#___#......#
########___########
#_________________#
:_________________:
#___###########___#
#_________________#
########___########
#_________________#
#______!!!!!______#
#______!!!!!______#
#______!!!!!______#
#________!________#
#_______!?!_______#
###################
