#########:#########
#......#___#......#
#......#___#......#
#......#___#......#
#......#___#......#
#......#___#......#
#......#___#......#
#......#___#......#
########___########
#______!_!_!______#
:_______!_!_______:
#______!_!_!______#
########___########
#......#___#......#
#......#___#......#
#......#___#......#
#......#___#......#
#......#___#......#
#......#___#......#
#......#___#......#
###################
