###################
#.................#
#.................#
#.................#
#.................#
#.................#
#.................#
#.................#
###################
#_________________#
:_________________:
#_________________#
########___########
#......#___#......#
#......#___#......#
#......#___#......#
#......#___#......#
#......#___#......#
#......#___#......#
#......#___#......#
#########:#########
