###################
#_______!?!_______#
#_______!!!_______#
#_________________#
#!!_____________!!#
#!!_____________!!#
#!!_____________!!#
#########_#########
#_________________#
#___###########___#
:_____!_!!!_!_____:
#______!_!_!______#
#_________________#
#_________________#
#_________________#
#_________________#
#_________________#
#_________________#
#_________________#
#_________________#
#########:#########
