###################
#.................#
#.................#
#.................#
#.................#
#.................#
#.................#
#.................#
#.................#
#.................#
#.................#
#.................#
#.................#
#.................#
#.................#
#.................#
###################
#_________________#
#_________________#
#_________________#
#########:#########
