###################
#_______#_#_______#
#_________________#
#______#####______#
#_________________#
#_________________#
#_________________#
#_________________#
#_________________#
#_________________#
#!_!_!_!_!_!_!_!_!#
#_________________#
#_________________#
#_________________#
#_________________#
#_________________#
#_________________#
#______#####______#
#_________________#
#_______#_#_______#
#########:#########
