###################
#.................#
#.................#
#.................#
#.................#
#.................#
#.................#
#.................#
#.................#
#.................#
#.................#
#.................#
#.................#
#.................#
#.................#
#.................#
###################
#______!!!!!______#
#____!!!___!!!____#
#__!!!!_____!!!!__#
#########:#########
