###################
#____?_?_?_?_?____#
#_!_!_!_!_!_!_!_!_#
#_________________#
#_________________#
#_________________#
#_________________#
#_________________#
#_!_!_!_!_!_!_!_!_#
#!_!_!_!_!_!_!_!_!#
#_________________#
#_________________#
#_________________#
#_________________#
#_____#######_____#
#_________________#
########___########
#_________________#
#_________________#
#_________________#
#########:#########
