###################
#_________________#
#_______________!_#
#_________________#
#_________________#
#_________!_______#
#_________________#
#_________________#
#_______________!_#
#_________________#
:_________________:
#_________________#
#_______________!_#
#_________________#
#_________________#
#_________!_______#
#_________________#
#_________________#
#_______________!_#
#_________________#
###################
