###################
#_________________#
#_______________#_#
#_______________#_#
#_______________#_#
#_______________#_#
######__________#_#
#____##_#_______#_#
#__#____#__!!!__#_#
#__##############_#
:__#............#_:
#__################
#__#____#!!!!!!!#?#
#____##_#_______#_#
######__________#_#
#_______________#_#
#_______________#_#
#_______________#_#
#_______________#_#
#_________________#
###################
