###################
#.................#
#.................#
#.................#
#.................#
#.................#
#.................#
###################
#________!________#
#_______!_!_______#
:______!_!_!______:
#_______!_!_______#
#________!________#
###################
#.................#
#.................#
#.................#
#.................#
#.................#
#.................#
###################
