###################
#_________________#
#_________________#
#_________________#
#_________________#
#_________________#
#_________________#
#_________________#
#_________________#
#_________________#
:____________!____#
#___________!_____#
#__________!!_____#
#___________!_____#
#____________!____#
#____________!____#
#___________!_____#
#__________!!_____#
#___________!_____#
#____________!____#
#########:#########
