###################
#_________________#
#_________________#
#_________________#
#_________________#
#_________________#
#_________________#
#_________________#
#_________________#
#_________________#
:_________________#
#_________________#
#___________!!!!!!#
#__________!!_____#
#_________!!______#
#________!!_______#
#_______!!________#
#______!!_________#
#_____!!__________#
#____!!__________?#
#########:#########
